******************
******-----**a****
***X**-----------*
***+**$----***=*-*
***+++AAAAA++++*B*
*----------------*
*b--------------$*
******************

P 8 1
X 3 2
a 13 1 6 3 1
b 1 6 16 6 1